0 0 587 587 0 587 587 587 0 587 0 0 0 0 587 587 0 0 587 0 587 0 0 587 587 587 0 587 587 587 587 0 587 0 0 0 587 587 587 0 587 0 587 0 0 0 0 587 0 587 0 0 0 0 0 0 0 0 0 0 0 587 0 0 0 587 587 0 587 587 0 0 587 0 0 587 0 587 0 0 0 587 0 0 0 0 
0 0 0 0 587 0 587 587 0 587 0 0 587 0 587 0 587 587 0 0 587 0 587 0 0 0 587 587 0 0 0 0 0 0 587 0 0 0 0 0 587 587 587 0 587 587 0 0 0 587 0 0 0 0 0 0 0 0 0 0 0 587 587 0 587 0 0 0 587 0 587 587 0 587 0 0 0 0 587 0 587 0 0 0 0 0 
0 0 0 587 0 587 587 587 0 0 0 587 0 0 587 0 0 0 587 0 0 0 0 587 0 587 587 0 587 0 0 587 0 587 0 587 0 587 587 0 587 0 587 587 0 0 0 587 587 0 0 0 0 0 0 0 587 0 587 587 0 0 0 0 587 587 0 587 587 587 0 0 587 0 0 0 0 587 0 0 0 0 0 0 0 0 
0 0 0 587 587 0 0 0 587 0 587 0 587 0 0 587 587 587 0 0 587 587 0 0 0 587 0 0 0 587 587 0 0 0 0 587 587 587 587 587 587 587 0 587 0 587 0 587 0 0 0 0 0 0 0 587 0 587 0 587 0 587 587 587 587 0 0 587 0 0 587 0 587 587 0 587 0 0 0 587 0 0 0 0 0 0 
0 0 0 0 0 587 0 587 0 0 0 587 587 0 587 0 587 0 587 0 587 587 587 0 587 587 0 587 0 0 0 0 587 587 0 587 0 0 587 0 587 587 0 587 587 0 587 587 0 0 0 0 587 587 0 587 587 0 587 0 0 587 587 587 587 0 587 0 587 0 587 587 0 0 0 0 587 0 0 0 0 0 0 0 0 0 
0 0 587 587 0 587 0 0 0 587 0 0 0 0 0 0 0 0 0 0 0 0 587 0 0 0 0 0 0 0 0 0 0 0 587 0 0 0 0 587 0 0 0 0 0 0 0 0 0 0 0 587 0 587 0 0 587 587 0 587 0 0 0 0 587 0 0 0 0 0 0 0 0 587 0 0 0 0 0 587 0 0 0 0 0 0 
0 0 0 587 587 0 0 0 587 587 587 587 587 587 587 587 587 587 587 587 587 587 587 587 587 587 587 587 587 587 587 587 587 587 587 587 587 587 587 587 587 587 587 587 587 587 587 587 0 0 0 587 587 587 587 587 587 587 587 587 587 587 587 587 587 587 587 587 587 587 587 587 587 587 587 587 587 587 587 0 0 0 0 0 0 0 
0 0 0 0 0 0 587 823 824 824 824 824 824 824 824 824 824 824 824 824 824 824 824 824 824 824 824 824 824 824 824 824 824 824 824 824 824 824 824 824 824 824 824 824 824 824 824 824 824 824 824 824 824 824 824 824 824 824 824 824 824 824 824 824 824 824 824 824 824 824 824 824 824 824 824 824 824 824 825 0 587 0 0 0 0 0 
0 0 587 0 587 587 0 0 584 0 584 0 584 0 584 0 584 0 584 0 584 0 584 0 0 584 0 0 584 0 584 0 0 0 584 0 0 0 0 584 0 0 0 584 0 0 0 0 994 995 996 0 0 0 0 0 0 0 0 0 0 0 588 0 588 0 588 0 588 0 588 0 588 0 588 0 588 0 0 0 0 0 0 0 0 0 
0 0 587 0 0 587 587 0 0 0 0 584 0 584 0 584 0 584 0 584 0 584 0 584 0 0 584 0 0 584 0 0 584 0 0 0 0 584 0 0 0 584 0 0 0 0 0 0 0 0 0 0 588 0 0 588 0 0 0 0 536 0 0 588 0 588 0 588 0 588 0 588 0 588 0 588 0 588 0 0 0 0 0 0 0 0 
0 0 0 0 587 0 0 0 0 0 0 0 584 0 584 0 584 0 584 0 584 0 584 0 584 0 0 584 0 0 0 0 0 0 0 584 0 0 0 0 0 0 0 0 0 584 0 584 0 0 0 0 0 0 588 0 0 0 0 0 0 0 0 0 588 0 588 0 588 0 0 0 588 0 588 0 588 0 0 587 0 0 0 0 0 0 
0 0 587 587 587 0 587 0 584 0 0 0 0 584 0 0 0 584 0 584 0 584 0 584 0 584 0 0 0 0 0 584 0 0 0 0 0 0 0 0 0 0 0 0 0 0 0 0 0 1253 0 0 0 0 0 0 0 0 0 0 0 0 0 0 0 0 0 0 0 0 588 0 0 588 0 588 0 588 0 0 0 0 0 0 0 0 
0 0 0 0 0 587 0 0 0 0 0 0 0 0 0 0 0 0 0 0 0 0 0 0 584 0 0 584 0 0 584 0 0 0 0 584 0 0 0 0 0 0 0 0 0 584 0 0 0 0 0 0 0 0 0 0 0 0 0 0 0 528 0 0 0 0 0 0 0 0 0 588 0 0 588 0 0 0 0 0 0 0 0 0 0 0 
0 0 587 587 0 0 0 0 0 0 0 0 0 0 0 0 0 0 584 0 0 584 0 0 0 584 0 0 0 0 0 0 0 584 0 0 0 0 0 0 0 0 0 584 0 0 0 0 0 0 0 0 0 585 0 588 0 588 0 0 0 0 0 655 0 0 0 655 0 528 0 0 588 0 0 588 0 588 0 0 0 0 0 0 0 0 
0 0 0 0 587 587 0 0 0 584 0 0 0 0 0 584 0 0 0 0 0 0 0 0 0 0 0 0 0 0 0 0 0 0 0 0 0 0 0 0 0 584 0 0 0 0 584 0 0 0 850 851 0 0 0 0 0 0 0 0 0 0 0 0 0 536 0 0 0 0 0 0 0 588 0 0 0 0 0 0 0 0 0 0 0 0 
0 0 0 0 0 0 0 0 0 0 0 0 0 0 0 0 0 0 0 584 0 0 0 0 584 0 0 0 584 0 0 0 584 0 0 0 0 0 0 0 0 0 0 584 0 0 0 0 0 0 0 0 588 0 589 589 589 0 0 0 0 0 0 0 0 0 0 528 0 617 618 0 0 0 0 588 0 0 0 587 0 0 0 0 0 0 
0 0 0 587 0 587 587 0 0 584 0 584 0 0 0 0 0 584 0 0 0 584 0 0 0 0 584 0 0 0 0 0 0 0 0 584 0 0 0 584 0 0 0 0 0 0 0 0 1359 0 0 0 0 0 0 0 0 0 528 0 0 0 0 0 0 0 0 0 0 0 0 0 528 0 0 0 0 0 0 0 0 0 0 0 0 0 
0 0 0 587 0 0 0 0 0 0 0 0 0 0 0 0 0 0 0 0 0 0 0 584 0 0 0 0 0 0 0 0 0 0 0 0 0 584 0 0 0 0 0 0 594 0 0 0 1359 0 0 0 0 0 0 0 0 0 0 0 0 0 0 0 0 0 0 0 0 0 0 0 0 0 0 0 0 0 0 0 0 0 0 0 0 0 
0 0 587 587 0 587 0 0 0 0 584 0 0 584 0 0 0 0 0 0 0 0 0 0 0 0 0 0 0 0 0 0 0 0 0 0 0 0 0 0 0 0 0 0 0 0 0 0 0 0 0 0 585 0 0 0 0 0 0 0 0 0 0 0 0 0 0 528 536 0 0 528 0 0 0 0 0 0 0 0 0 0 0 0 0 0 
0 0 0 0 587 587 587 0 584 0 0 0 0 0 0 0 0 0 584 0 0 0 0 0 0 0 0 0 619 620 0 0 0 0 584 0 0 0 0 0 0 0 0 0 0 0 0 0 0 0 0 0 0 0 589 0 588 0 0 0 0 0 0 0 0 0 0 0 0 0 0 0 0 0 0 0 0 0 0 0 0 0 0 0 0 0 
0 0 0 0 0 0 0 0 0 0 0 0 0 0 0 0 0 0 0 0 0 0 584 0 0 0 0 0 0 0 0 0 0 0 0 0 0 0 0 0 594 0 0 0 0 0 0 0 0 1253 0 0 0 0 0 0 0 0 588 0 588 0 0 0 0 0 0 0 0 617 618 0 1247 0 0 0 0 0 0 0 0 0 0 0 0 0 
0 0 0 587 587 0 0 0 0 0 0 0 0 0 0 0 0 0 0 0 0 0 0 0 0 0 0 0 0 0 0 0 0 0 0 0 0 0 0 0 0 0 584 0 0 0 584 0 0 0 0 0 0 0 0 0 0 0 0 0 0 0 0 0 0 0 0 0 0 0 0 0 0 0 0 0 0 0 0 0 0 0 0 0 0 0 
0 0 587 0 587 587 0 0 0 0 0 0 0 0 0 0 0 0 0 0 0 0 0 0 0 584 0 0 0 0 0 0 584 0 0 0 0 0 0 0 0 0 0 0 0 0 0 0 0 0 0 0 0 0 585 0 0 1195 0 0 0 0 0 0 0 0 0 528 0 0 0 0 528 0 0 617 618 0 0 0 0 0 0 0 0 0 
0 0 0 587 0 587 0 0 0 1252 0 0 1252 0 0 0 0 0 0 0 0 0 0 0 0 0 0 0 0 584 0 0 0 0 0 584 0 0 0 0 0 0 0 0 0 0 0 0 0 0 0 0 589 0 0 0 588 0 0 585 0 0 528 0 0 0 0 0 0 0 0 0 0 0 0 0 0 0 0 0 0 0 0 0 0 0 
0 0 587 0 0 0 0 0 0 0 0 0 0 0 0 0 0 0 0 0 0 0 0 0 0 0 0 0 0 0 0 0 0 0 0 0 0 594 0 0 584 0 0 0 0 0 0 0 1253 0 0 585 0 0 588 0 0 0 0 0 0 589 0 0 0 0 0 0 0 0 0 0 0 0 528 0 0 0 0 0 0 0 0 0 0 0 
0 0 0 587 587 0 587 0 0 0 1252 0 0 1252 0 0 0 0 0 0 0 0 0 0 0 0 0 0 0 0 0 0 0 0 0 0 0 0 0 0 0 0 0 0 0 0 0 0 0 0 0 0 0 0 0 0 0 0 0 0 0 0 0 0 589 0 0 22 0 0 0 0 0 0 534 0 528 0 0 0 0 0 0 0 0 0 
0 0 0 0 587 587 0 0 0 0 0 0 0 0 0 0 0 0 0 0 0 0 0 0 0 0 0 0 0 0 0 0 584 0 0 0 0 0 0 0 0 0 0 584 0 0 0 0 0 0 0 0 589 0 0 0 0 619 620 0 588 0 0 0 0 0 0 0 22 0 0 0 0 0 0 0 0 0 0 0 0 0 0 0 0 0 
0 0 587 0 0 587 587 0 0 0 0 0 1252 0 0 0 0 0 0 0 0 0 0 0 0 0 0 0 0 0 0 0 0 0 0 0 0 0 0 0 0 0 0 0 0 0 0 0 0 0 0 0 0 0 0 0 0 0 0 0 0 0 0 0 588 0 0 0 0 0 0 0 0 0 528 0 655 0 0 0 0 0 0 0 0 0 
0 0 0 0 0 587 0 0 814 814 814 815 225 0 0 0 0 0 0 0 0 0 0 0 0 0 0 0 0 0 584 0 0 0 0 0 0 0 0 0 0 0 0 0 0 0 0 0 0 0 0 0 0 1195 0 589 0 0 0 589 0 0 0 0 0 22 0 0 0 588 0 0 0 0 0 0 0 0 0 587 0 0 0 0 0 0 
0 0 0 587 587 0 0 0 0 0 0 0 225 0 0 0 0 0 0 0 0 0 0 0 0 0 0 0 0 0 0 0 0 0 0 0 0 0 0 0 0 0 0 0 0 0 594 0 0 0 0 0 588 0 0 0 0 0 0 0 0 0 0 22 0 22 0 0 0 0 0 528 0 0 0 0 528 0 0 0 0 0 0 0 0 0 
0 0 0 0 587 0 0 0 0 0 0 0 225 0 0 0 0 0 0 0 1154 0 0 0 0 0 0 0 0 0 584 0 0 0 0 0 0 0 0 0 0 0 584 0 0 0 0 0 0 0 0 0 0 0 588 0 585 0 0 0 0 22 0 22 0 0 588 0 0 0 588 0 0 0 0 0 0 0 0 0 0 0 0 0 0 0 
0 0 587 0 587 0 0 0 0 0 0 0 225 0 0 0 0 0 0 0 1098 0 0 0 0 0 0 0 0 0 0 0 0 0 0 0 0 0 0 0 0 0 0 0 0 0 0 0 0 0 0 0 0 0 0 589 0 0 22 0 22 0 0 589 0 0 0 0 0 589 0 0 0 0 0 0 0 0 0 0 0 0 0 0 0 0 
0 0 0 587 0 587 587 0 0 0 0 0 225 0 0 0 0 0 0 0 0 0 0 0 0 0 0 0 0 0 0 0 0 0 0 0 584 0 0 0 0 0 0 0 0 0 0 0 0 0 0 0 0 0 0 589 0 22 0 22 0 589 0 0 0 0 0 588 0 0 0 585 0 0 0 0 0 0 0 0 0 0 0 0 0 0 
0 0 0 0 587 587 587 0 0 0 0 0 225 0 0 0 0 0 0 0 0 417 1417 1422 1422 1422 1422 1422 1422 1418 0 0 0 0 0 0 0 0 0 494 494 494 0 1417 1422 1422 1422 1422 1422 1422 1422 1418 0 0 0 0 0 0 0 0 0 0 0 0 0 0 0 0 588 0 0 0 0 0 0 528 0 0 0 587 0 0 0 0 0 0 
0 0 587 587 587 587 0 0 0 0 0 0 225 0 0 0 0 0 0 0 0 0 1417 1422 1422 1422 1422 1422 1422 1418 0 0 0 0 0 0 0 0 0 494 494 494 0 1417 1422 1422 1422 1422 1422 1422 1422 1418 0 589 0 0 0 0 0 0 0 0 0 0 0 589 0 0 0 0 1363 1218 1219 1362 0 0 0 0 0 0 0 0 0 0 0 0 
0 0 0 0 0 587 0 0 103 223 105 0 0 0 0 0 0 0 0 0 1154 417 0 0 587 0 0 587 0 0 0 0 587 0 0 0 0 0 587 0 0 0 0 0 0 0 0 0 0 0 0 0 0 0 0 0 0 1362 0 0 0 585 0 1195 0 0 1195 589 0 0 1363 1332 1333 1362 0 588 0 0 0 0 587 0 0 0 0 0 
0 0 0 587 0 587 0 0 0 0 0 0 1252 0 0 0 0 0 0 0 1098 0 0 0 0 0 0 0 0 0 0 0 0 0 0 0 0 0 0 0 0 0 0 0 0 0 0 0 0 0 589 0 589 0 0 0 0 1362 0 0 0 0 0 0 589 0 0 0 0 534 1363 110 270 1362 0 0 0 588 0 0 0 0 0 0 0 0 
0 0 0 587 0 587 0 0 0 0 0 0 0 0 0 0 0 0 0 0 0 0 0 0 0 587 0 0 587 0 0 0 0 587 0 0 587 0 0 0 587 0 0 0 0 0 0 0 0 0 0 0 0 0 586 0 589 1362 0 0 0 0 588 0 0 588 0 0 0 534 1363 208 0 1362 0 0 0 0 0 587 0 0 0 0 0 0 
0 0 587 0 0 587 0 0 0 1252 0 0 0 0 0 0 0 0 0 0 0 0 587 0 0 0 0 0 0 0 0 0 0 0 0 0 0 0 0 0 0 0 0 0 0 0 0 0 0 0 0 0 0 0 0 0 0 1362 0 0 0 0 0 0 0 0 0 0 0 0 1360 1365 1365 1361 0 585 0 589 0 0 0 0 0 0 0 0 
0 0 0 0 587 587 0 0 0 0 0 0 0 0 0 0 0 0 0 0 0 0 0 0 587 0 0 0 0 587 0 0 0 0 0 587 0 0 0 0 0 0 587 0 0 0 0 0 0 0 0 0 0 0 0 589 0 1362 0 589 0 0 0 585 0 0 0 0 0 0 589 0 0 0 0 0 0 0 0 0 0 0 0 0 0 0 
0 0 587 0 0 587 0 0 0 0 1252 0 0 0 0 0 0 0 0 0 0 0 0 0 0 0 0 587 0 0 0 0 587 0 0 0 0 0 587 0 0 0 0 0 0 0 0 0 0 619 620 0 0 0 0 0 0 1362 0 0 0 0 0 0 0 589 0 0 0 0 0 0 0 0 0 0 0 0 0 0 587 0 0 0 0 0 
0 0 0 587 0 0 0 0 1252 0 0 0 1252 0 0 0 0 0 0 0 587 0 0 0 0 0 0 0 0 0 0 0 0 0 0 0 0 0 0 0 0 0 0 0 0 0 0 0 0 0 0 0 0 0 586 0 589 1362 0 0 0 0 0 0 0 0 0 0 0 0 0 1195 0 0 0 823 824 825 0 0 0 0 0 0 0 0 
0 0 0 0 0 587 587 0 0 0 0 0 0 0 0 0 0 0 0 0 0 0 587 0 0 587 0 0 0 0 0 0 0 0 587 0 587 0 0 0 0 587 0 0 0 0 0 0 0 0 0 0 0 0 0 0 0 1362 0 0 0 0 0 0 0 0 0 0 0 589 0 585 0 0 1363 0 0 0 0 587 0 0 0 0 0 0 
0 0 587 587 587 587 0 0 587 0 587 0 0 0 0 0 0 0 0 0 0 0 0 0 0 0 0 587 0 0 0 0 0 0 0 0 0 0 0 0 0 0 0 0 0 0 0 0 0 0 0 0 0 589 0 0 0 1362 0 0 0 0 0 0 0 0 0 0 0 0 0 0 0 589 1363 0 0 0 0 0 0 0 0 0 0 0 
0 0 0 0 0 587 0 0 0 587 0 587 0 0 0 0 587 0 0 0 0 0 0 0 0 0 0 0 0 0 0 0 0 0 0 0 0 0 587 0 0 0 0 0 0 0 0 0 0 0 0 586 0 0 0 0 0 1362 0 0 0 0 0 0 0 0 0 0 0 0 0 0 0 0 1363 0 0 0 0 0 0 0 0 0 0 0 
0 0 587 0 587 0 0 0 0 0 587 0 587 0 587 0 0 0 587 0 587 0 0 587 0 0 0 0 0 0 0 0 587 0 0 587 0 0 0 0 587 0 0 0 0 0 0 0 0 0 0 0 0 0 0 589 0 1362 0 0 0 0 874 0 0 589 0 22 22 22 22 22 22 22 1363 0 0 0 0 0 0 0 0 0 0 0 
0 0 0 0 587 0 0 0 0 587 0 587 0 587 0 0 587 0 0 0 0 0 0 0 0 587 0 0 0 587 0 587 0 0 0 0 0 0 0 0 0 0 0 0 0 0 0 0 0 0 0 0 0 0 0 0 0 1362 0 0 0 1332 51 1333 0 0 0 0 0 0 0 0 0 0 1363 0 0 0 0 0 0 0 0 0 0 0 
0 0 587 0 587 587 0 0 587 0 0 0 0 0 0 0 0 0 0 0 0 0 0 0 0 0 587 0 0 0 0 0 0 0 587 0 587 0 587 0 0 587 0 0 0 0 0 0 0 0 586 0 0 589 0 0 0 1362 589 0 0 103 165 0 650 0 0 0 22 22 22 22 22 22 1363 0 206 0 0 587 0 0 0 0 0 0 
0 0 0 587 587 0 587 0 0 0 0 0 587 0 587 0 0 0 0 0 0 0 0 0 0 0 0 0 587 0 0 0 587 0 0 0 0 0 0 0 0 0 0 0 0 0 0 0 594 0 0 0 0 0 0 589 0 0 0 0 1359 1359 207 1359 1359 0 0 0 0 593 529 0 593 0 1417 1422 1422 1422 0 0 0 0 0 0 0 0 
0 0 0 587 0 587 0 0 0 587 0 0 0 0 0 0 0 0 0 617 618 0 0 0 0 0 0 587 0 587 0 0 0 0 587 587 587 587 587 587 587 587 0 0 0 0 0 0 651 0 0 0 589 0 0 0 589 0 0 0 0 0 0 589 0 0 0 0 0 0 0 650 0 0 0 593 0 0 0 0 0 0 0 0 0 0 
0 0 0 0 587 587 0 0 587 0 587 0 0 587 0 0 0 0 0 0 0 0 0 0 0 0 0 0 0 0 0 587 0 0 0 0 0 0 0 0 0 0 0 0 0 0 0 0 0 0 586 0 0 0 0 0 0 0 0 0 0 0 0 0 0 0 0 0 0 0 0 593 0 0 0 0 0 589 0 587 0 0 0 0 0 0 
0 0 587 587 0 587 0 0 0 0 0 0 0 0 0 0 0 0 0 0 0 0 0 617 618 0 0 0 0 0 0 0 0 587 0 1363 0 1225 874 1226 0 1362 0 0 0 0 0 0 0 0 0 0 0 0 0 0 0 0 0 589 0 0 0 0 0 0 0 0 0 0 589 0 0 589 0 589 0 0 0 0 0 0 0 0 0 0 
0 0 587 0 0 0 587 0 0 587 0 0 587 0 0 0 0 0 0 0 0 0 0 0 0 0 0 0 0 0 0 0 587 0 0 1363 0 1339 393 1340 0 1362 0 0 0 0 0 0 0 0 0 0 0 0 0 589 0 589 0 0 0 0 0 0 0 0 0 0 0 589 0 589 0 0 589 0 0 0 0 587 0 0 0 0 0 0 
0 0 587 0 587 0 587 0 587 0 587 0 0 587 0 587 0 0 0 0 0 0 0 0 0 0 0 0 0 0 587 0 0 0 587 1363 0 0 507 213 0 1362 0 0 0 0 0 0 0 0 586 0 0 0 0 0 0 0 0 0 0 0 650 0 529 589 0 0 0 0 589 0 589 0 0 0 589 0 0 0 0 0 0 0 0 0 
0 0 0 0 0 0 0 0 0 0 0 587 0 0 0 0 0 0 587 0 587 0 587 0 587 0 587 0 0 0 0 0 0 587 0 1363 0 0 208 0 0 1362 0 0 0 0 0 0 0 0 0 0 0 0 0 0 0 0 529 0 0 0 589 0 589 0 589 0 0 0 0 0 0 0 589 0 0 0 0 0 587 0 0 0 0 0 
0 0 0 587 0 587 0 0 0 0 0 0 587 0 587 0 587 0 0 0 0 0 0 0 0 0 0 0 0 587 0 0 0 0 0 1359 1359 1359 1357 1359 1359 1359 1360 1365 1365 1365 1365 1365 1361 0 0 0 0 589 0 0 0 0 0 589 529 589 0 589 0 589 0 589 0 589 0 0 0 0 0 0 0 0 0 0 0 0 0 0 0 0 
0 0 0 0 0 0 587 0 0 0 0 0 0 587 0 587 0 587 0 587 0 587 0 587 0 587 0 587 0 0 0 0 0 0 0 0 0 0 0 0 0 1360 1365 1365 1365 1365 1365 1365 1361 0 0 589 0 0 0 0 0 0 589 0 589 0 589 0 589 0 589 0 589 0 589 0 0 0 0 0 0 0 0 587 587 0 0 0 0 0 
0 0 587 587 0 587 0 0 0 0 0 0 0 0 0 0 0 0 587 0 587 0 587 0 587 0 587 0 587 0 587 0 587 0 587 0 0 0 0 0 0 0 0 0 0 0 0 0 0 0 0 0 0 0 0 0 0 589 0 589 0 589 0 589 0 589 0 589 0 589 0 0 0 623 0 617 618 0 0 0 0 0 0 0 0 0 
0 0 0 0 587 0 0 820 821 821 821 821 821 821 821 821 821 821 821 821 821 821 821 821 821 821 821 821 821 821 821 821 821 821 821 821 821 821 821 821 821 821 821 821 821 821 821 821 821 821 821 821 821 821 821 821 821 821 821 821 821 821 821 821 821 821 821 821 821 821 821 821 821 821 821 821 821 821 822 587 0 0 0 0 0 0 
0 0 0 587 0 587 587 0 0 587 0 587 0 587 587 0 587 0 0 0 0 587 0 587 0 587 0 0 0 0 0 0 587 0 0 0 0 587 0 587 0 0 0 0 0 0 1139 0 0 0 0 0 0 587 0 0 0 0 0 587 0 0 587 0 0 587 0 587 0 587 0 0 587 0 0 0 0 0 0 0 587 0 0 0 0 0 
0 0 0 0 587 0 0 0 587 0 0 0 587 587 0 0 587 0 587 0 0 0 587 0 0 0 0 0 587 0 587 0 0 587 0 587 0 0 0 587 0 587 0 1423 0 0 0 0 0 0 587 0 0 587 0 0 0 587 0 0 587 0 587 0 0 587 0 0 587 0 587 0 0 587 0 587 0 587 0 587 0 0 0 0 0 0 
0 0 587 587 0 587 587 587 0 587 587 587 0 587 587 587 0 0 0 587 587 0 587 0 587 587 587 0 0 0 587 587 587 0 587 0 0 587 0 0 0 587 0 0 0 1423 0 0 587 0 0 0 587 587 0 587 0 0 0 587 0 587 0 0 587 0 587 587 0 587 587 587 0 587 587 0 0 587 587 0 0 0 0 0 0 0 
0 0 0 587 0 0 0 0 0 0 0 0 0 0 0 0 587 0 0 587 0 0 0 0 0 0 0 0 0 587 0 0 0 0 587 0 0 0 0 587 587 0 0 1139 0 534 0 0 0 0 587 0 0 0 587 0 0 587 0 0 0 0 0 587 0 587 587 0 587 0 0 587 0 587 0 587 0 0 0 0 0 0 0 0 0 0 
0 0 0 0 0 0 0 0 0 0 0 0 0 0 0 0 0 0 0 0 0 0 0 0 0 0 0 0 0 0 0 0 0 0 0 0 0 0 0 0 0 0 0 0 0 0 0 1195 0 0 0 0 0 0 0 0 0 0 0 0 0 0 0 0 0 0 0 0 0 0 0 0 0 0 0 0 0 0 0 0 0 0 0 0 0 0 
0 0 0 0 0 0 0 0 0 0 0 0 0 0 0 0 0 0 0 0 0 0 0 0 0 0 0 0 0 0 0 0 0 0 0 0 0 0 0 0 0 0 0 0 0 0 0 0 0 0 0 0 0 0 0 0 0 0 0 0 0 0 0 0 0 0 0 0 0 0 0 0 0 0 0 0 0 0 0 0 0 0 0 0 0 0 
0 0 0 0 0 0 0 0 0 0 0 0 0 1195 0 0 0 0 0 0 0 0 0 0 1195 0 0 0 0 0 0 0 0 0 0 0 0 0 1139 0 0 0 116 0 0 1423 0 115 0 0 0 0 0 0 0 1139 0 0 0 0 0 0 0 1139 0 0 0 0 0 0 0 0 0 0 0 0 0 0 1139 0 0 0 0 0 0 0 
0 0 0 0 0 0 0 0 0 0 0 1139 0 0 0 0 1080 0 0 0 0 0 0 0 0 0 0 0 0 1423 0 0 0 0 0 0 1423 0 0 0 0 0 0 0 0 0 0 0 0 0 0 1423 1080 0 0 0 0 0 1423 0 0 0 0 0 0 0 0 0 0 1423 0 0 0 0 0 0 1423 0 0 0 0 0 0 0 0 0
