0 0 0 0 0 0 0 0 0 0 0 0 0 0 0 0 0 0 0 0 0 0 0 0 0 0 0 0 0 0 0 0 0 0 0 0 0 0 0 0 0 0 0 0 0 0 0 0 0 0 0 0 0 0 0 0 0 0 0 0 0 0 0 0 0 0 0 0 0 0 0 0 0 0 0 0 0 0 0 0 0 0 0 0 0 0 
0 0 0 0 0 0 0 0 0 0 0 0 0 0 0 0 0 0 0 0 0 0 0 0 0 0 0 0 0 0 0 0 0 0 0 0 0 0 0 0 0 0 0 0 0 0 0 0 0 0 0 0 0 0 0 0 0 0 0 0 0 0 0 0 0 0 0 0 0 0 0 0 0 0 0 0 0 0 0 0 0 0 0 0 0 0 
0 0 0 0 0 0 0 0 0 0 0 0 0 0 0 0 0 0 0 0 0 0 0 0 0 0 0 0 0 0 0 0 0 0 0 0 0 0 0 0 0 0 0 0 0 0 0 0 0 0 0 0 0 0 0 0 0 0 0 0 0 0 0 0 0 0 0 0 0 0 0 0 0 0 0 0 0 0 0 0 0 0 0 0 0 0 
0 0 0 0 0 0 0 0 0 0 0 0 0 0 0 0 0 0 0 0 0 0 0 0 0 0 0 0 0 0 0 0 0 0 0 0 0 0 0 0 0 0 0 0 0 0 0 0 0 0 0 0 0 0 0 0 0 0 0 0 0 0 0 0 0 0 0 0 0 0 0 0 0 0 0 0 0 0 0 0 0 0 0 0 0 0 
0 0 0 0 0 0 0 0 0 0 0 0 0 0 0 0 0 0 0 0 0 0 0 0 0 0 0 0 0 0 0 0 0 0 0 0 0 0 0 0 0 0 0 0 0 0 0 0 0 0 0 0 0 0 0 0 0 0 0 0 0 0 0 0 0 0 0 0 0 0 0 0 0 0 0 0 0 0 0 0 0 1025 1139 0 0 0 
0 0 0 0 0 0 0 0 0 0 0 0 0 0 0 0 0 0 0 0 0 0 0 0 0 0 0 0 0 0 0 0 0 0 0 0 0 0 0 0 0 0 0 0 0 0 0 0 0 0 0 0 0 0 0 0 0 0 0 0 0 0 0 0 0 0 0 0 0 0 0 0 0 0 0 0 0 0 0 0 0 0 0 0 0 0 
0 0 0 0 0 0 0 0 0 0 0 0 0 0 0 0 0 0 0 0 0 0 0 0 0 0 0 0 0 0 0 0 0 0 0 0 0 0 0 0 0 0 0 0 0 0 0 0 0 0 0 0 0 0 0 0 0 0 0 0 0 0 0 0 0 0 0 0 0 0 0 0 0 0 0 0 0 0 0 0 0 0 0 0 0 0 
0 0 0 0 0 0 0 0 0 0 0 0 0 0 0 0 0 0 0 0 0 0 0 0 0 0 0 0 0 0 0 0 0 0 0 0 0 0 0 0 0 0 0 0 0 0 0 0 0 0 0 0 0 0 0 0 0 0 0 0 0 0 0 0 0 0 0 0 0 0 0 0 0 0 0 0 0 0 0 0 0 0 1253 0 0 0 
0 0 0 0 0 0 0 0 0 0 0 0 0 0 0 0 0 0 0 0 0 0 0 0 0 0 0 0 0 0 0 0 0 0 0 0 0 0 0 0 0 0 0 0 0 0 0 0 0 0 0 0 0 0 0 0 0 0 0 0 0 0 0 0 0 0 0 0 0 0 0 0 0 0 0 0 0 0 0 0 0 0 0 0 0 0 
0 0 0 0 0 0 0 0 0 205 0 0 0 0 0 0 0 0 0 0 0 0 0 0 0 0 0 0 0 0 0 0 0 0 0 0 0 0 0 0 0 0 0 0 0 0 0 0 0 0 0 578 0 0 0 0 0 615 0 0 0 0 645 0 645 0 645 0 645 0 645 0 645 0 645 0 645 0 0 0 0 0 0 0 0 0 
0 0 0 0 0 0 0 0 0 0 0 0 0 0 0 0 0 0 0 0 0 0 0 0 0 0 0 0 0 0 0 0 0 0 650 0 0 0 0 0 0 0 0 0 0 0 0 0 0 0 0 578 645 0 0 645 0 0 0 0 0 0 0 645 0 645 0 645 0 645 0 645 0 645 0 645 0 645 0 0 0 0 0 0 0 0 
0 0 0 0 0 0 0 0 0 0 0 0 0 0 0 0 0 0 0 0 0 0 0 0 0 0 0 0 0 0 0 0 0 0 0 0 650 650 0 0 0 0 0 0 0 0 0 0 0 0 0 578 650 0 645 0 650 0 0 615 0 0 0 0 645 0 645 0 645 0 0 0 645 0 645 0 645 0 0 0 0 0 0 0 0 0 
0 0 0 0 0 0 0 0 0 0 655 0 0 0 0 0 0 0 0 0 0 0 0 0 0 0 0 0 0 0 0 0 0 650 0 0 0 0 0 0 345 346 347 0 0 0 0 0 0 0 1367 578 0 0 0 0 650 0 0 0 0 0 0 0 0 0 0 0 0 0 645 0 0 645 0 645 0 645 0 0 0 0 0 0 0 0 
0 0 0 0 0 0 0 0 0 0 0 0 650 0 0 0 650 0 0 0 650 0 0 0 0 0 0 0 0 0 0 0 0 0 0 0 650 0 345 346 343 460 461 0 0 0 0 0 0 0 521 577 650 0 0 0 0 0 0 615 0 0 0 0 0 0 0 0 0 0 0 645 0 0 645 0 0 0 0 0 0 0 0 0 0 0 
0 0 0 0 0 0 0 0 0 0 0 0 0 0 0 0 0 0 0 0 0 0 0 650 0 0 650 0 0 655 0 0 0 0 0 650 0 0 459 460 461 0 0 0 0 0 0 0 0 0 578 0 0 0 0 645 0 645 0 0 0 0 0 0 0 0 0 0 0 0 0 0 645 0 0 645 0 645 0 0 0 1025 1139 0 0 0 
0 0 0 0 0 0 0 0 0 0 0 0 0 0 0 0 0 650 0 0 0 0 650 0 0 0 0 0 0 0 0 0 0 0 0 0 0 650 0 0 0 0 0 0 545 0 0 0 0 0 578 0 0 0 0 0 0 0 0 0 0 615 0 1413 0 0 0 0 0 0 0 0 0 645 0 0 0 0 0 0 0 0 0 0 0 0 
0 0 0 0 0 0 0 0 0 0 0 0 0 655 0 650 0 0 0 0 0 0 0 0 0 0 0 0 0 0 655 0 0 0 0 0 0 0 0 0 0 0 0 0 0 542 0 0 0 521 577 0 645 0 646 646 646 0 0 0 0 0 615 0 0 0 0 1413 0 674 675 0 0 0 0 645 0 0 0 0 0 0 1253 0 0 0 
0 0 0 0 0 0 0 0 0 0 0 0 0 0 0 0 650 0 0 0 0 0 0 0 0 0 0 0 0 0 0 0 0 0 0 0 0 0 0 0 0 0 0 0 0 0 0 0 795 578 1377 1377 1377 1377 1377 1377 1377 1377 1377 1377 1377 1377 0 0 0 0 0 0 0 0 0 0 0 0 0 0 616 0 0 0 0 0 1253 0 0 0 
0 0 0 0 0 0 0 0 0 0 0 0 0 0 0 0 0 0 0 655 0 0 0 0 0 0 0 0 0 0 0 0 0 655 0 0 0 0 0 650 545 0 0 0 651 0 545 0 0 635 520 0 0 0 0 593 0 0 0 0 0 0 0 615 0 0 0 0 0 0 0 0 0 614 614 671 0 0 0 1025 0 0 0 0 0 0 
0 0 0 0 0 0 0 0 0 0 0 0 0 0 0 0 0 0 0 0 0 0 0 0 0 0 0 417 0 0 0 0 0 0 0 0 0 545 0 0 0 0 0 545 0 543 0 0 0 0 578 0 0 0 0 0 0 0 0 650 0 0 0 0 0 536 0 0 0 0 0 0 0 0 0 0 0 616 0 0 0 0 0 0 0 0 
0 0 0 0 0 0 0 0 0 0 0 593 0 0 0 0 0 0 0 0 0 0 0 0 0 0 0 477 676 677 448 0 0 0 0 542 0 544 543 0 0 0 0 0 0 0 0 542 0 0 578 0 0 0 646 0 645 0 0 0 0 0 0 0 615 0 536 0 536 0 0 0 1070 1070 1070 1070 1070 1070 0 0 0 0 0 0 0 0 
0 0 0 0 0 0 0 0 0 593 0 0 650 0 0 650 0 0 0 593 0 0 0 0 593 0 0 0 0 472 0 0 0 0 0 0 0 0 0 0 651 0 0 0 543 0 0 0 0 0 578 0 536 0 0 0 650 0 645 0 645 0 0 0 0 615 0 0 0 674 675 0 0 616 0 0 0 0 0 0 1139 0 0 0 0 0 
0 0 0 0 0 0 0 0 0 0 0 0 0 0 0 0 0 0 0 0 0 650 0 0 0 0 0 0 650 0 0 0 0 0 544 0 543 0 0 0 0 0 0 0 0 0 0 0 0 0 578 0 0 0 0 0 0 0 0 0 536 650 0 0 0 0 0 0 0 0 0 0 0 0 0 0 0 0 0 0 0 0 0 0 0 0 
0 0 0 0 0 0 0 0 0 0 0 0 0 0 0 0 0 0 0 650 0 0 0 0 0 0 0 650 0 0 0 0 0 0 650 0 0 0 0 0 0 543 0 0 0 0 0 0 0 0 578 0 0 0 0 0 0 0 0 0 0 0 0 0 0 615 0 0 0 0 0 0 20 0 0 674 675 0 0 0 0 0 0 0 0 0 
0 0 0 0 0 0 0 0 0 0 0 0 0 0 0 0 0 0 0 0 0 0 593 0 0 0 0 650 0 0 0 0 0 0 0 0 0 0 0 0 0 0 0 597 542 0 545 0 0 0 578 0 646 0 0 0 645 655 0 0 0 0 0 0 0 0 615 0 0 0 0 0 0 0 0 0 0 0 0 0 0 0 1253 0 0 0 
0 0 0 0 0 0 0 0 0 0 0 0 0 0 0 0 0 955 0 0 0 0 0 0 1139 0 0 0 0 0 0 0 545 543 543 0 0 651 0 0 0 0 0 0 0 0 0 0 0 0 578 0 0 0 645 650 0 0 0 0 0 646 623 0 0 0 0 0 0 0 615 0 0 0 0 0 0 0 0 0 0 0 0 0 0 0 
0 0 0 0 0 0 0 0 0 0 0 0 0 0 0 613 613 0 0 0 650 593 0 0 0 0 0 0 650 0 544 0 0 0 0 0 0 0 0 0 0 542 542 0 0 543 0 542 0 0 578 0 0 0 0 650 417 0 0 417 0 0 680 0 646 0 0 0 0 0 0 0 615 0 0 0 0 205 0 0 0 0 0 0 0 0 
0 0 0 0 0 0 0 0 0 0 0 0 0 0 0 0 687 688 689 0 0 0 0 0 0 0 1139 0 0 0 0 0 0 0 0 0 0 597 0 543 0 543 0 0 0 0 0 0 0 0 635 520 646 0 650 593 0 676 677 0 645 0 0 0 0 536 0 0 650 0 615 0 0 0 0 0 0 0 0 0 1025 0 0 0 0 0 
0 0 0 0 0 0 0 0 0 0 0 0 0 0 0 0 744 745 746 0 0 0 593 593 0 0 0 0 0 0 0 0 0 0 0 542 0 0 655 0 0 0 0 0 597 0 0 1252 0 909 966 578 520 0 0 0 0 471 0 0 0 593 0 536 645 0 0 0 0 0 0 0 0 0 615 0 0 0 0 0 0 0 0 0 0 0 
0 0 0 0 0 0 0 0 814 814 814 815 0 0 0 0 744 745 746 0 0 0 0 0 0 0 0 0 0 0 0 0 0 0 0 0 545 0 0 0 0 542 0 0 0 0 0 0 0 653 0 578 0 0 0 646 0 0 0 646 0 0 0 0 0 0 0 0 0 645 0 0 0 0 0 0 0 0 0 0 0 0 0 0 0 0 
0 0 0 0 0 0 0 0 814 814 814 815 0 0 0 0 744 745 746 0 0 0 0 655 0 0 0 0 0 0 0 0 0 0 543 0 0 542 0 543 0 0 0 0 0 0 651 599 0 0 0 578 645 0 0 0 0 0 655 0 0 0 0 0 0 0 0 0 593 0 0 0 536 0 615 0 615 0 0 0 0 1253 0 0 0 0 
0 0 0 0 0 0 0 0 814 814 814 815 0 0 0 0 744 745 746 0 0 593 0 655 0 0 0 0 0 0 0 0 0 0 596 0 0 543 0 0 0 543 0 0 544 0 656 0 0 0 1367 578 0 0 645 0 0 0 0 0 0 0 0 0 0 0 645 0 0 0 645 0 0 0 0 0 0 0 0 0 0 0 0 0 0 0 
0 0 0 0 0 0 0 0 814 814 814 815 0 0 0 0 744 745 746 0 1155 0 0 0 0 593 0 0 655 0 0 542 0 0 0 0 0 0 0 542 0 0 0 0 0 0 0 0 0 0 0 578 0 0 0 646 0 0 0 0 0 0 0 646 0 0 0 0 0 646 0 0 0 536 0 0 0 615 0 0 1025 0 0 0 0 0 
0 0 0 0 0 0 0 0 814 814 814 815 0 0 0 0 801 802 803 0 0 0 0 0 0 0 0 0 0 0 0 0 0 0 543 0 0 0 0 0 0 0 0 0 0 0 0 0 0 0 521 579 793 794 0 646 0 0 0 0 0 646 650 0 736 737 0 645 0 0 0 0 0 0 0 0 0 0 0 0 0 0 0 0 0 0 
0 0 0 0 0 0 0 0 814 814 814 815 0 0 0 0 0 0 0 0 0 0 0 0 0 0 0 0 0 0 0 0 0 0 0 0 0 0 0 0 0 0 0 0 0 738 795 795 795 852 1150 1150 1150 0 0 0 22 0 0 0 0 0 0 0 0 0 0 0 645 0 1359 1359 1359 1359 0 0 0 615 0 0 0 0 1138 0 0 0 
0 0 0 0 0 0 0 0 874 874 874 875 0 0 0 0 687 688 689 0 0 0 0 0 0 0 0 0 0 0 0 0 0 0 0 650 0 0 0 0 0 0 0 593 0 0 0 0 0 0 578 0 0 646 0 0 0 0 0 0 0 0 0 0 0 646 0 0 0 655 0 874 874 0 0 0 0 0 0 0 0 0 0 0 0 0 
0 0 0 0 0 0 0 0 869 869 869 872 0 0 955 0 801 802 803 0 0 0 0 0 644 0 0 644 0 650 0 650 644 0 530 650 0 0 644 0 650 0 0 0 1252 0 0 0 0 0 578 0 0 0 0 0 0 0 0 650 0 0 0 0 0 593 0 646 0 0 0 873 875 0 0 645 0 0 0 0 0 0 0 0 0 0 
0 0 0 0 0 0 0 0 0 0 0 0 0 0 613 613 613 0 0 0 1155 0 0 0 0 0 0 0 0 0 0 0 0 0 0 0 0 0 0 0 0 0 530 0 0 0 0 0 0 521 646 0 646 0 0 0 0 0 0 650 0 0 0 0 646 0 0 0 0 0 0 870 872 0 0 0 0 645 0 0 0 0 0 0 0 0 
0 0 0 0 0 0 0 0 0 0 0 0 0 174 175 176 0 0 650 0 0 0 0 0 0 644 0 0 644 0 0 0 0 644 0 0 644 0 530 0 644 0 0 0 0 653 0 1367 0 578 0 0 0 0 643 0 646 0 0 0 650 0 645 0 0 645 0 623 0 0 0 0 0 0 0 0 0 0 0 0 0 0 1253 0 0 0 
0 0 0 0 0 0 0 0 0 0 0 0 0 231 232 233 0 650 0 593 0 0 644 0 0 0 530 0 0 0 0 0 650 0 0 0 0 0 0 0 0 0 0 0 0 0 0 0 521 577 593 0 532 0 0 0 0 0 0 0 0 650 0 0 0 0 0 0 0 0 0 0 0 0 0 0 0 646 0 0 0 0 0 0 0 0 
0 0 0 0 0 0 0 0 0 0 0 0 0 288 289 290 0 0 0 0 0 0 530 0 644 0 0 0 0 644 0 0 0 0 655 644 0 530 0 0 655 0 644 0 0 0 0 521 577 0 0 0 593 0 0 646 0 0 0 646 0 0 0 650 0 0 0 0 0 0 646 0 532 593 0 0 0 0 0 0 0 0 0 0 0 0 
0 0 0 0 0 0 0 0 0 0 0 0 0 0 0 0 0 0 593 0 0 0 0 0 0 0 0 644 0 650 0 0 644 0 0 0 0 0 644 0 0 0 0 0 1253 0 0 635 0 676 677 0 0 0 0 0 0 0 0 0 0 0 0 0 0 646 0 0 0 0 0 0 0 0 1417 0 0 0 0 0 0 0 0 0 0 0 
0 0 0 0 0 0 0 0 0 0 0 0 0 0 0 0 650 0 0 0 644 0 0 0 530 0 0 650 0 0 0 650 0 0 650 0 0 0 0 0 0 0 0 0 0 0 0 0 578 541 0 470 0 0 643 0 646 0 0 0 0 0 0 0 0 650 0 0 0 0 0 0 0 0 0 0 0 0 0 0 0 0 0 0 0 0 
0 0 0 0 0 0 0 0 0 0 0 0 0 0 0 0 0 655 0 0 0 0 644 0 0 644 0 0 0 530 0 0 0 0 644 0 644 0 593 0 655 644 0 0 0 0 0 0 635 520 533 0 0 0 0 0 0 0 0 0 0 0 0 0 0 0 0 0 0 646 0 0 0 0 0 0 159 0 0 0 0 0 0 0 0 0 
0 0 0 0 0 0 0 0 644 0 644 0 0 655 0 0 0 0 0 0 0 0 0 0 0 650 0 644 0 0 0 655 0 0 0 0 0 0 0 0 0 0 0 0 0 0 0 0 0 578 0 0 0 646 0 0 0 0 0 0 0 0 0 0 0 0 0 0 0 0 0 0 0 646 0 0 216 0 0 0 0 0 0 0 0 0 
0 0 0 0 0 0 0 0 0 644 0 644 0 0 0 0 644 0 0 0 0 655 0 0 0 0 0 0 650 0 0 0 0 0 0 0 593 0 644 0 0 0 0 0 0 0 0 1368 0 578 0 643 0 650 0 0 0 0 0 0 1359 1359 1359 1359 1359 0 0 0 0 0 0 0 0 0 0 0 0 0 0 0 1025 0 0 0 0 0 
0 0 0 0 0 0 0 0 0 0 644 0 644 0 644 0 0 0 644 0 644 0 0 644 0 0 0 655 0 0 0 0 644 0 655 644 0 0 0 593 644 0 0 0 0 0 0 0 521 577 0 0 0 0 0 646 0 0 0 0 1363 874 874 874 1362 646 0 0 0 0 0 0 0 0 0 880 881 882 0 0 0 0 0 0 0 0 
0 0 0 0 0 0 0 0 0 644 0 644 0 644 0 0 644 0 0 0 0 0 0 0 0 644 0 0 0 644 0 644 0 0 0 0 0 0 0 0 0 0 1309 0 0 0 0 0 578 0 0 0 650 0 0 0 0 0 0 0 1363 873 874 875 1362 0 1035 0 0 0 0 0 0 0 0 877 876 879 0 0 0 0 1253 0 0 0 
0 0 0 0 0 0 0 0 644 0 0 0 0 0 0 0 0 0 471 0 0 0 0 0 595 0 644 0 0 0 0 0 0 0 644 0 644 0 644 0 0 644 0 0 653 0 0 599 578 0 643 0 0 646 0 0 0 0 646 0 1363 870 869 872 1362 1035 0 0 0 0 0 0 0 0 1363 0 0 0 0 0 1138 0 0 0 0 0 
0 0 0 0 0 0 0 0 0 0 0 0 644 0 644 0 0 0 0 0 0 415 0 655 0 0 0 0 644 0 0 0 644 0 0 0 0 0 0 0 0 0 0 0 0 0 0 599 578 0 0 0 0 0 0 646 0 0 0 0 0 0 0 0 0 0 0 0 0 0 0 0 0 0 0 0 0 0 0 0 0 0 0 0 0 0 
0 0 0 0 0 0 0 0 0 0 0 0 0 0 0 0 0 541 0 674 675 612 0 0 471 0 0 644 0 644 0 0 0 0 644 1359 1359 1359 1359 1359 1359 1359 0 0 0 0 0 0 578 0 0 0 646 0 650 0 646 0 0 0 650 0 0 646 0 0 0 0 0 650 0 0 0 0 0 0 0 0 0 0 0 0 0 0 0 0 
0 0 0 0 0 0 0 0 0 0 0 0 0 644 0 0 0 598 0 0 0 0 595 0 0 415 0 0 0 0 0 644 0 0 0 0 0 0 0 0 0 0 0 0 0 0 0 1366 578 0 643 0 0 0 0 0 0 0 0 0 0 0 0 0 0 0 0 0 0 0 0 0 0 0 0 0 1137 0 0 0 0 0 0 0 0 0 
0 0 0 0 0 0 0 0 205 0 0 0 0 0 0 0 0 595 0 736 737 0 0 674 675 612 0 0 0 0 0 0 0 644 0 0 0 0 0 0 0 0 0 1423 0 1025 0 0 578 0 0 650 0 0 650 0 0 0 0 646 0 0 0 0 0 0 0 0 0 0 0 0 0 0 0 0 0 1137 0 0 0 0 1025 0 0 0 
0 0 0 0 0 0 0 0 0 0 0 0 0 0 0 0 0 0 0 0 0 471 0 567 0 0 0 0 0 0 0 0 644 0 0 0 0 0 0 0 0 0 0 0 0 0 0 0 578 0 0 0 0 0 0 646 0 646 0 650 532 0 0 0 0 0 0 0 0 0 0 0 0 1137 0 1137 0 0 0 0 0 0 0 0 0 0 
0 0 0 0 0 0 0 0 0 0 0 0 0 0 0 0 0 0 0 0 0 0 0 0 0 0 0 0 0 0 644 0 0 0 644 0 0 0 0 0 0 0 0 0 0 0 1367 0 578 0 643 0 0 0 0 650 0 0 0 0 0 0 0 0 0 0 0 0 0 0 0 0 0 0 0 0 0 0 0 0 0 0 0 0 0 0 
0 0 0 0 0 0 0 0 0 0 0 0 0 0 0 0 0 0 0 0 0 0 0 0 0 0 0 0 0 0 0 0 0 644 0 0 0 0 0 0 0 0 0 1423 0 0 0 0 578 0 0 593 0 0 0 650 532 650 0 0 0 0 0 0 0 0 0 0 0 0 0 0 0 0 0 1194 0 0 0 0 0 0 1253 0 0 0 
0 0 0 0 0 0 0 0 0 0 0 0 0 0 0 0 0 0 0 0 0 0 0 0 0 0 0 0 0 0 0 0 0 0 0 0 0 0 0 0 0 0 738 795 795 795 795 795 1150 593 0 0 0 646 0 0 0 650 0 0 0 0 0 0 0 0 0 0 0 0 0 0 0 0 0 0 0 1251 0 0 0 0 0 0 0 0 
0 0 0 0 0 0 0 0 0 0 0 0 0 0 0 0 0 0 0 0 0 0 0 0 0 0 0 0 0 0 0 0 0 0 0 0 0 0 0 0 0 0 0 0 0 0 0 0 578 0 0 646 0 0 532 650 0 0 0 0 0 0 0 0 0 0 0 0 0 0 0 0 0 0 0 0 0 0 0 0 0 0 0 1138 0 0 
0 0 0 0 0 0 0 0 0 0 0 0 0 0 0 0 0 0 0 0 0 0 0 0 0 0 0 0 0 0 0 0 0 0 0 0 0 0 205 0 0 0 1023 995 0 0 0 1368 578 532 0 0 0 0 0 0 0 0 0 0 0 0 0 0 0 0 0 0 0 0 0 0 0 0 0 674 675 205 0 0 0 0 0 0 0 0 
0 0 0 0 0 0 0 0 0 0 0 0 0 0 0 0 0 0 0 0 0 0 0 0 0 0 0 0 0 0 0 0 0 0 0 0 0 0 0 0 0 0 994 995 995 995 995 996 0 0 0 0 0 0 0 0 0 0 0 0 0 0 0 0 0 0 0 0 0 0 0 0 0 0 0 0 0 0 0 0 0 1025 0 0 0 0 
0 0 0 0 0 0 0 0 0 0 0 0 0 0 0 0 0 0 0 0 0 0 0 0 0 0 0 0 0 0 0 0 0 0 0 0 0 0 0 0 0 0 0 0 0 0 0 0 0 0 0 0 0 0 0 0 0 0 0 0 0 0 0 0 0 0 0 0 0 0 0 0 0 0 0 0 0 0 0 0 0 0 0 0 0 0 
0 0 0 0 0 0 0 0 0 0 0 0 0 0 0 0 0 0 0 0 0 0 0 0 0 0 0 0 0 0 0 0 0 0 0 0 0 0 0 0 0 0 0 0 0 1025 0 0 0 0 0 0 0 0 0 0 0 0 0 0 0 0 0 0 0 0 0 0 0 0 0 0 0 0 0 0 0 0 0 0 0 0 0 0 0 0 
0 0 0 0 0 0 0 0 0 0 0 0 0 0 0 0 0 0 0 0 0 0 0 0 0 0 0 0 0 0 0 0 0 0 0 0 0 0 0 0 0 0 0 0 0 0 0 0 0 0 0 0 0 0 0 0 0 0 0 0 0 0 0 0 0 0 0 0 0 0 0 0 0 0 0 0 0 0 0 0 0 0 0 0 0 0 
0 0 0 0 0 0 0 0 0 0 0 0 0 0 0 0 0 0 0 0 0 0 0 0 0 0 0 0 0 0 0 0 0 0 0 0 0 0 0 0 0 0 0 0 0 1025 0 0 0 0 0 0 0 0 0 0 0 0 0 0 0 0 0 0 0 0 0 0 0 0 0 0 0 0 0 0 0 0 0 0 0 0 1253 0 0 0 
0 0 0 0 0 0 0 0 0 0 0 0 0 0 0 0 0 0 0 0 0 0 0 0 0 0 0 0 0 0 0 0 0 0 0 0 0 0 0 0 0 0 0 1025 0 0 0 0 0 0 0 0 0 0 0 0 0 0 0 0 0 0 0 0 0 0 0 0 0 0 0 0 0 0 0 0 0 0 0 0 0 0 0 0 0 0 
0 0 0 0 0 0 0 0 0 0 0 0 0 0 0 0 0 0 0 0 0 0 0 0 0 0 0 0 0 0 0 0 0 0 0 0 0 0 0 0 1025 0 0 0 0 0 0 0 1025 0 0 0 0 0 0 0 0 0 0 0 0 0 0 0 0 0 0 0 0 0 0 0 0 0 0 0 0 0 0 0 0 1138 0 0 0 0 
0 0 0 0 0 0 0 0 0 0 0 0 0 0 0 0 0 0 0 0 0 0 0 0 0 0 0 0 0 0 0 0 0 0 0 0 0 0 0 0 0 0 0 0 0 0 0 0 0 0 0 0 0 0 0 0 0 0 0 0 0 0 0 0 0 0 0 0 0 0 0 0 0 0 0 0 0 0 0 0 0 0 0 0 0 0
