0 0 0 0 0 0 0 0 0 0 0 0 0 0 0 0 0 0 0 0 0 0 0 0 0 0 0 0 0 0 0 0 0 0 0 0 0 0 0 0 0 0 0 0 0 0 0 0 0 0 0 0 0 0 0 0 0 0 0 0 0 0 0 0 0 0 0 0 0 0 0 0 
0 0 0 0 0 0 0 0 0 0 0 0 0 0 0 0 0 0 0 0 0 0 0 0 0 0 0 0 0 0 0 0 0 0 0 0 0 0 0 0 0 0 0 0 0 0 0 0 0 0 0 0 0 0 0 0 0 0 0 0 0 0 0 0 0 0 0 0 0 0 0 0 
0 641 0 641 0 641 0 641 0 641 0 641 0 641 0 641 0 0 641 0 0 641 0 641 0 0 0 641 0 0 0 0 641 0 0 0 641 0 0 0 0 60 61 61 61 0 0 0 0 1319 1204 1263 1263 1263 1263 1263 1263 1263 1263 1263 1263 1263 1263 1263 1263 1263 1263 1263 1263 1263 1263 0 
0 0 409 0 641 0 641 0 641 0 641 0 641 0 641 0 641 0 0 641 0 0 641 0 0 641 0 0 0 0 641 0 0 0 641 0 0 0 0 0 0 60 61 61 61 0 0 0 0 0 1319 1204 1263 1263 1263 1263 1263 1263 1263 1263 1263 1263 1263 1263 1263 1263 1263 1263 1263 1263 1263 0 
0 0 409 0 0 641 0 641 0 641 0 641 0 641 0 641 0 641 0 0 641 0 0 0 0 0 0 0 641 0 0 0 0 0 0 0 0 0 641 0 641 60 61 61 61 0 0 0 0 0 0 1262 1263 1263 1263 1263 1263 1263 1263 1263 1263 1263 1263 1263 1263 1263 1263 1263 1263 1263 1263 0 
0 641 409 0 0 0 641 0 0 0 641 0 641 0 641 0 641 0 641 0 0 0 0 0 641 0 0 0 0 0 0 0 0 0 0 0 0 0 0 0 0 60 61 61 61 0 0 0 0 0 0 1262 1263 1263 1263 1263 1263 1263 1263 1263 1263 1263 1263 1263 1263 1263 1263 1263 1263 1263 1263 0 
0 0 409 0 0 0 0 0 0 0 0 0 0 0 0 0 0 641 0 0 641 0 0 641 0 0 0 0 641 0 0 0 0 0 0 0 0 0 641 0 0 60 61 61 0 0 0 0 0 0 0 1319 1320 1204 1263 1263 1263 1263 1263 1263 1263 1263 1263 1263 1263 1263 1263 1263 1263 1263 1263 0 
0 0 464 466 408 0 0 0 0 0 0 641 0 0 641 0 0 0 641 0 0 0 0 0 0 0 641 0 0 0 0 0 0 0 0 0 641 0 0 0 0 60 61 61 0 0 642 0 0 0 0 0 0 1262 1263 1263 1263 1263 1263 1263 1263 1263 1263 1263 1263 1263 1263 1263 1263 1263 1263 0 
0 0 641 0 464 408 0 0 641 0 0 0 0 0 0 0 0 0 0 0 0 0 0 0 0 0 0 0 0 0 0 0 0 0 641 0 0 0 0 641 0 60 61 61 0 0 0 0 0 0 0 0 0 1262 1263 1263 1263 1263 1263 1263 1263 1263 1263 1263 1263 1263 1263 1263 1263 1263 1263 0 
0 0 0 0 0 409 0 0 0 0 0 0 641 0 0 0 0 641 0 0 0 641 0 0 0 641 0 0 0 0 0 0 0 0 0 0 641 0 0 0 0 60 61 0 0 0 0 0 0 0 0 0 0 1319 1320 1204 1263 1263 1263 1263 1263 1263 1263 1263 1263 1263 1263 1263 1263 1263 1263 0 
0 0 641 0 641 464 408 0 0 0 641 0 0 0 641 0 0 0 0 641 0 0 0 0 0 0 0 0 641 0 0 0 641 0 521 466 466 466 466 466 466 60 61 0 0 0 0 0 0 0 0 0 0 0 0 1262 1263 1263 1263 1263 1263 1263 1263 1263 1263 1263 1263 1263 1263 1263 1263 0 
0 0 0 0 0 0 464 408 0 0 0 0 0 0 0 0 641 0 521 522 522 522 522 522 523 0 0 0 0 0 641 0 0 0 409 0 0 0 0 0 0 60 61 0 0 0 0 0 0 0 0 0 0 0 0 1262 1263 1263 1263 1263 1263 1263 1263 1263 1263 1263 1263 1263 1263 1263 1263 0 
0 0 0 641 0 0 641 464 466 466 466 466 466 466 466 466 466 466 520 579 579 579 579 579 580 0 0 0 0 0 0 0 0 0 409 0 0 0 0 0 0 60 61 61 0 642 0 0 0 0 0 0 0 0 0 1262 1263 1263 1263 1263 1263 1263 1263 1263 1263 1263 1263 1263 1263 1263 1263 0 
0 641 0 0 0 0 0 0 0 0 0 641 0 0 0 0 0 0 635 520 579 579 579 579 580 0 0 641 0 0 0 0 521 466 637 0 0 0 0 0 0 60 61 61 0 0 0 0 0 0 0 0 0 0 0 1262 1263 1263 1263 1263 1263 1263 1263 1263 1263 1263 1263 1263 1263 1263 1263 0 
0 0 0 0 0 0 0 0 0 0 0 0 0 0 0 641 0 0 0 635 636 636 636 636 580 0 0 0 0 0 0 0 409 0 0 0 0 0 0 0 0 60 61 61 0 0 0 0 0 0 0 0 0 0 0 1319 1320 1320 1204 1263 1263 1263 1263 1263 1263 1263 1263 1263 1263 1263 1263 0 
0 864 864 864 864 864 864 864 864 864 864 865 0 0 0 0 0 0 0 0 0 0 0 0 409 0 0 0 0 0 0 407 637 0 0 641 0 0 0 641 0 60 61 61 0 0 0 0 0 0 0 0 0 0 0 0 0 0 1262 1263 1263 1263 1263 1263 1263 1263 1263 1263 1263 1263 1263 0 
0 921 921 921 921 921 921 921 921 921 921 922 0 0 0 0 0 0 641 0 0 0 0 0 409 641 0 0 0 0 0 409 0 0 0 0 0 0 0 0 0 60 61 61 0 0 0 642 0 0 0 0 0 0 0 0 0 0 1262 1263 1263 1263 1263 1263 1263 1263 1263 1263 1263 1263 1263 0 
0 921 921 921 921 921 921 921 921 921 921 918 865 0 0 0 0 3 4 5 63 0 641 0 409 0 0 0 641 521 466 637 0 0 0 0 0 0 0 0 0 60 61 61 0 0 0 0 0 0 0 0 642 0 0 0 0 0 1319 1320 1320 1320 1204 1263 1263 1263 1263 1263 1263 1263 1263 0 
0 921 921 921 921 921 921 921 921 921 921 921 922 0 0 0 3 116 58 119 0 0 0 0 409 0 0 0 0 409 0 0 0 641 0 0 0 0 0 0 0 60 61 61 642 0 0 0 0 0 0 0 0 0 0 0 0 0 0 0 0 0 1262 1263 1263 1263 1263 1263 1263 1263 1263 0 
0 921 921 921 921 921 921 921 921 921 921 921 922 0 0 0 117 59 115 5 63 0 0 0 409 0 0 521 466 637 0 0 0 0 0 0 0 0 0 0 0 60 61 61 0 0 0 0 0 0 0 0 0 0 0 0 0 0 0 1091 1150 1374 179 179 179 179 179 179 179 179 179 0 
0 921 921 921 921 921 921 921 921 921 921 921 918 865 0 0 0 117 59 115 5 63 0 0 409 641 0 409 0 0 0 0 0 0 0 0 641 0 0 0 0 60 61 61 0 0 0 0 0 0 0 0 0 0 0 0 0 0 0 1093 0 0 1319 1320 1320 1320 1204 1263 1263 1263 1263 0 
0 921 921 921 921 921 921 921 921 921 921 921 921 922 0 0 0 0 117 59 115 5 63 0 409 521 466 637 0 0 0 0 0 0 0 0 0 0 0 0 3 116 61 61 61 642 0 0 0 0 0 0 0 0 0 0 0 0 0 1093 0 0 0 0 0 0 1262 1263 1263 1263 1263 0 
0 874 874 874 874 921 921 921 921 921 921 921 921 922 0 0 0 0 3 116 58 119 0 641 464 406 0 0 0 0 0 0 0 0 0 0 0 0 0 0 60 61 61 61 61 0 0 0 0 0 0 0 0 0 0 0 0 1205 1150 1149 0 0 0 0 0 0 1262 1263 1263 1263 1263 0 
0 874 874 874 874 921 921 921 921 921 921 921 921 922 0 0 0 0 60 1423 62 0 0 0 0 409 0 0 0 0 0 0 0 0 0 0 0 0 0 0 60 61 61 61 61 0 0 0 0 0 0 0 0 0 0 1205 1150 1321 0 0 0 0 0 0 0 0 1262 1263 1263 1263 1263 0 
0 874 874 874 874 921 921 921 921 921 921 921 921 922 0 0 0 0 117 118 119 0 0 641 0 409 0 0 0 0 0 0 0 0 0 641 0 0 0 3 116 61 61 61 61 0 0 0 0 642 0 0 1205 1150 1150 1149 0 0 0 0 0 0 0 0 0 0 1319 1320 1320 1204 1263 0 
0 874 874 874 874 921 921 921 921 921 921 921 921 922 0 0 0 0 0 0 0 0 0 0 0 409 0 0 0 0 0 0 0 0 0 0 0 0 0 60 61 61 61 61 61 0 0 0 0 0 0 1205 1321 0 0 0 0 0 0 0 0 0 0 0 0 0 0 0 0 1262 1263 0 
0 874 874 874 874 921 921 921 921 921 921 921 921 918 865 0 0 0 0 0 0 0 0 0 0 409 0 0 0 641 0 0 0 0 0 0 0 0 3 116 61 61 61 61 61 0 0 0 0 0 1205 1149 0 0 0 0 0 0 0 0 0 0 0 0 642 0 0 0 0 1262 1263 0 
0 874 874 874 874 179 179 179 179 179 179 179 921 921 918 808 808 808 808 808 808 466 466 405 466 463 466 466 466 466 466 466 466 466 466 466 466 466 60 61 61 61 61 462 1150 1150 1150 1150 1150 1150 1090 0 0 0 0 0 0 0 0 0 0 0 0 0 0 0 0 0 0 1319 1204 0 
0 921 921 921 921 921 921 921 921 921 921 921 921 861 979 0 0 0 0 0 0 0 0 409 0 0 0 0 0 0 0 0 0 0 0 0 0 3 116 61 61 61 61 61 0 0 0 0 0 0 1093 0 0 0 0 0 0 0 0 0 0 0 0 0 0 0 0 0 0 0 1319 0 
0 921 921 921 921 921 921 921 921 921 921 921 861 979 0 0 0 0 0 0 0 0 0 409 0 0 0 0 0 0 0 0 0 0 0 0 0 60 61 61 61 61 61 61 0 0 0 0 0 0 1093 0 0 0 642 0 0 0 0 0 0 0 0 0 0 0 0 0 0 0 0 0 
0 921 921 921 921 921 921 921 921 921 921 861 979 0 0 0 0 0 0 0 0 0 0 409 0 0 0 0 0 0 0 0 0 0 0 0 0 60 61 61 61 61 61 0 0 0 0 0 0 0 1093 0 0 0 0 0 0 0 0 0 0 0 0 0 0 0 0 0 0 0 0 0 
0 921 921 921 921 921 921 921 921 921 861 979 0 0 0 0 0 0 0 0 0 0 0 409 0 0 0 0 0 0 0 0 0 0 0 0 0 60 61 61 61 61 61 0 0 0 0 0 0 0 1093 0 0 0 0 0 0 0 0 0 0 0 0 0 0 0 0 0 0 0 0 0 
0 921 921 921 921 921 921 921 921 861 979 0 0 0 0 0 0 0 0 0 0 0 0 409 0 0 0 0 0 0 0 0 0 0 0 0 0 60 61 61 61 61 0 0 0 0 0 0 0 0 1093 0 0 0 0 0 0 0 0 0 1029 1031 0 0 0 0 0 0 642 0 0 0 
0 921 921 921 921 921 921 921 921 922 0 0 0 0 0 0 0 0 0 0 0 0 0 409 0 0 0 0 0 0 0 0 0 0 0 0 3 116 61 61 61 0 0 0 0 0 0 0 0 0 1093 0 0 0 0 0 642 0 0 1029 1085 1088 0 0 0 0 0 0 0 0 0 0 
0 921 921 921 921 921 921 861 978 979 0 0 0 0 0 0 0 0 0 0 0 0 0 409 0 0 0 0 0 0 0 0 0 0 0 0 60 61 61 61 61 0 0 0 0 0 0 0 0 0 1093 1194 0 0 535 0 0 0 0 1143 1028 1088 0 0 0 0 0 0 0 0 0 0 
0 978 978 978 978 978 978 979 0 0 0 0 0 0 0 0 0 0 0 0 0 0 0 409 0 0 0 0 0 0 0 0 0 0 0 0 60 61 61 61 61 61 0 0 0 0 0 0 0 0 1093 0 1251 0 0 0 535 0 0 0 1143 1145 0 0 0 0 0 0 887 888 889 0 
0 0 0 0 0 0 0 0 0 0 0 0 0 0 0 0 0 0 0 0 0 0 0 409 0 0 0 0 0 0 0 0 0 0 0 0 60 61 61 61 61 61 0 0 0 0 0 0 0 0 1093 1194 0 0 0 0 0 0 0 535 0 0 0 0 642 0 0 0 887 888 889 0 
0 0 0 0 0 0 0 0 0 0 0 0 0 0 0 0 0 0 0 0 0 0 0 409 0 0 0 0 0 0 0 0 0 0 0 3 116 61 61 61 61 61 61 0 0 0 0 0 0 0 1093 0 0 535 0 0 0 0 0 0 0 0 0 0 0 0 0 0 887 888 889 0 
0 0 0 0 0 0 0 0 0 0 0 0 0 0 0 0 0 0 0 0 0 0 0 409 0 0 0 0 0 0 0 0 0 0 0 60 61 1424 61 61 61 61 61 0 0 0 0 0 0 0 1093 0 0 0 0 0 0 0 0 0 0 0 0 0 0 0 0 0 887 888 889 0 
0 0 0 0 0 0 0 0 0 0 0 0 0 0 0 0 0 0 0 0 0 0 0 409 0 0 0 0 0 0 0 0 0 0 0 60 61 61 61 61 61 61 0 0 0 0 0 0 0 0 1093 0 0 0 0 0 0 0 0 0 863 864 864 864 864 864 864 864 864 0 0 0 
0 0 0 0 0 0 0 0 0 0 0 521 522 522 522 522 522 523 0 0 0 0 0 409 0 0 0 0 0 0 0 0 0 0 0 60 61 61 61 61 61 61 0 0 0 0 0 0 0 0 1093 0 535 0 0 0 0 0 0 0 977 978 978 978 978 978 978 978 0 0 0 0 
0 0 0 0 0 0 0 0 0 0 521 577 579 579 579 579 579 579 523 0 0 0 0 409 0 0 0 0 0 0 0 0 0 0 0 60 61 61 61 61 61 61 0 0 0 0 0 0 0 0 1093 0 0 0 0 0 0 0 0 0 0 0 0 0 0 0 0 0 0 529 0 0 
0 0 0 0 0 0 0 0 0 521 577 579 579 579 579 579 579 579 580 0 0 0 0 409 0 0 0 0 0 0 0 0 0 0 0 60 61 61 61 61 61 61 0 0 0 0 0 0 0 0 1148 1150 1150 1150 1150 1089 1150 1150 1207 0 535 0 0 0 0 0 535 0 0 0 0 0 
0 0 644 0 0 0 0 0 521 577 579 579 579 579 579 579 579 579 576 523 0 0 0 409 0 0 0 0 644 644 644 644 644 644 644 60 61 61 61 61 61 61 0 0 0 0 0 0 0 0 0 0 0 0 1091 1149 0 0 1148 1092 0 0 535 0 0 0 0 0 0 0 0 0 
0 644 0 644 0 0 0 0 578 579 579 579 579 579 579 579 579 579 579 576 523 0 0 409 0 0 0 0 0 593 0 0 0 0 0 60 61 61 61 61 61 61 0 0 0 0 0 0 0 0 0 1091 1150 1150 1149 0 0 0 593 1093 0 0 0 0 0 0 0 0 0 0 646 0 
0 466 466 466 466 466 466 466 520 579 579 579 579 579 579 579 579 579 579 579 576 523 0 409 0 0 0 0 0 0 874 874 874 593 0 60 61 61 61 61 61 61 0 0 0 0 1091 1150 1150 1150 1150 1149 0 0 0 0 529 0 0 1148 1207 650 0 646 0 0 646 0 646 0 0 0 
0 0 644 0 0 644 0 0 635 636 636 520 579 579 579 579 579 579 579 579 579 579 466 463 408 0 0 0 593 0 873 874 875 0 0 60 61 61 61 61 61 61 0 0 0 0 1093 0 0 0 0 0 0 0 0 0 0 0 0 650 1148 1207 646 0 646 0 0 646 0 0 0 0 
0 644 587 644 0 0 644 0 644 0 0 635 636 636 636 636 636 636 636 636 636 637 0 0 409 0 0 0 0 0 870 869 872 0 593 60 61 61 61 61 61 61 0 0 0 0 1093 0 0 0 0 0 0 0 0 0 0 0 646 0 0 1148 1207 646 0 646 0 0 0 646 0 0 
0 587 644 587 644 0 0 0 0 0 0 644 0 644 0 644 0 644 0 644 0 0 0 0 409 0 0 0 0 0 0 0 0 0 0 60 61 61 61 61 61 61 0 0 0 1091 1149 0 0 0 0 0 0 0 0 646 0 646 0 646 0 0 1148 1150 1150 1092 593 646 0 0 529 0 
0 644 587 644 587 644 0 644 0 644 0 0 0 0 0 0 0 0 0 0 0 0 644 0 464 466 466 466 466 466 466 405 466 466 466 60 61 61 61 61 61 1150 1150 1150 1150 1149 0 0 0 0 0 0 646 0 646 0 646 0 646 0 646 0 646 0 650 1262 1206 1206 1206 1206 1206 0 
0 587 644 587 644 587 644 587 644 587 644 0 644 0 644 0 644 0 644 0 644 0 0 0 0 0 0 0 0 0 0 409 0 0 0 60 61 61 61 61 61 61 0 0 0 0 0 0 0 0 0 646 0 646 0 646 0 646 0 646 0 646 0 646 1205 1261 1263 1263 1263 1263 1263 0 
0 644 0 644 0 644 0 644 0 644 0 644 0 644 0 644 0 644 0 644 0 644 0 644 0 644 0 644 0 0 0 409 0 0 0 60 61 61 61 61 61 61 0 0 0 0 0 0 0 0 646 0 646 0 646 0 646 0 646 0 646 0 646 0 1262 1263 1263 1263 1263 1263 1263 0 
0 0 0 0 0 0 0 0 0 0 0 0 0 0 0 0 0 0 0 0 0 0 0 0 0 0 0 0 0 0 0 0 0 0 0 0 0 0 0 0 0 0 0 0 0 0 0 0 0 0 0 0 0 0 0 0 0 0 0 0 0 0 0 0 0 0 0 0 0 0 0 0